"filename", "language", "C++", "comment", "blank", "total"
"/home/gayou1025/桌面/MyWebServer/code/http/httpconn.cpp", "C++", 1, 2, 0, 3
"/home/gayou1025/桌面/MyWebServer/code/http/httpconn.h", "C++", 0, 1, 0, 1
"/home/gayou1025/桌面/MyWebServer/code/http/httprequest.cpp", "C++", -4, 34, 24, 54
"/home/gayou1025/桌面/MyWebServer/code/http/httpresponse.cpp", "C++", 7, 16, 8, 31
"/home/gayou1025/桌面/MyWebServer/code/http/httpresponse.h", "C++", 1, 0, 1, 2
"/home/gayou1025/桌面/MyWebServer/code/log/blockqueue.hpp", "C++", 0, 1, 0, 1
"/home/gayou1025/桌面/MyWebServer/code/log/log.cpp", "C++", 0, 1, 0, 1
"/home/gayou1025/桌面/MyWebServer/code/log/log.h", "C++", 0, 2, 0, 2
"/home/gayou1025/桌面/MyWebServer/code/pool/sqlconnRAII.hpp", "C++", 0, 1, 0, 1
"/home/gayou1025/桌面/MyWebServer/code/pool/threadpool.hpp", "C++", 0, 1, 0, 1
"/home/gayou1025/桌面/MyWebServer/code/server/epoller.cpp", "C++", -1, -1, -1, -3
"/home/gayou1025/桌面/MyWebServer/code/server/webserver.cpp", "C++", -3, 1, 3, 1
"/home/gayou1025/桌面/MyWebServer/code/timer/heaptimer.cpp", "C++", 0, 1, 1, 2
"Total", "-", 1, 60, 36, 97