"filename", "language", "C++", "comment", "blank", "total"
"/home/gayou1025/桌面/MyWebServer/code/buffer/buffer.cpp", "C++", 135, 30, 64, 229
"/home/gayou1025/桌面/MyWebServer/code/buffer/buffer.h", "C++", 40, 0, 16, 56
"/home/gayou1025/桌面/MyWebServer/code/http/httpconn.cpp", "C++", 123, 29, 61, 213
"/home/gayou1025/桌面/MyWebServer/code/http/httpconn.h", "C++", 42, 1, 21, 64
"/home/gayou1025/桌面/MyWebServer/code/http/httprequest.cpp", "C++", 266, 64, 112, 442
"/home/gayou1025/桌面/MyWebServer/code/http/httprequest.h", "C++", 58, 2, 19, 79
"/home/gayou1025/桌面/MyWebServer/code/http/httpresponse.cpp", "C++", 175, 33, 60, 268
"/home/gayou1025/桌面/MyWebServer/code/http/httpresponse.h", "C++", 38, 0, 16, 54
"/home/gayou1025/桌面/MyWebServer/code/log/blockqueue.hpp", "C++", 155, 20, 75, 250
"/home/gayou1025/桌面/MyWebServer/code/log/log.cpp", "C++", 172, 48, 68, 288
"/home/gayou1025/桌面/MyWebServer/code/log/log.h", "C++", 59, 4, 22, 85
"/home/gayou1025/桌面/MyWebServer/code/main.cpp", "C++", 10, 0, 7, 17
"/home/gayou1025/桌面/MyWebServer/code/pool/sqlconnRAII.hpp", "C++", 21, 3, 12, 36
"/home/gayou1025/桌面/MyWebServer/code/pool/sqlconnpool.cpp", "C++", 75, 21, 32, 128
"/home/gayou1025/桌面/MyWebServer/code/pool/sqlconnpool.h", "C++", 31, 4, 15, 50
"/home/gayou1025/桌面/MyWebServer/code/pool/threadpool.hpp", "C++", 64, 6, 24, 94
"/home/gayou1025/桌面/MyWebServer/code/server/epoller.cpp", "C++", 51, 18, 26, 95
"/home/gayou1025/桌面/MyWebServer/code/server/epoller.h", "C++", 23, 0, 12, 35
"/home/gayou1025/桌面/MyWebServer/code/server/webserver.cpp", "C++", 270, 53, 78, 401
"/home/gayou1025/桌面/MyWebServer/code/server/webserver.h", "C++", 55, 3, 21, 79
"/home/gayou1025/桌面/MyWebServer/code/timer/heaptimer.cpp", "C++", 125, 25, 50, 200
"/home/gayou1025/桌面/MyWebServer/code/timer/heaptimer.h", "C++", 47, 1, 17, 65
"Total", "-", 2035, 365, 828, 3228